..WWWWW..
LWFFFFFWL
.WFFBFFW.
.WFFFFFW.
.WFFFFFW.
.WFFFFFW.
EWFFFFFWE
.WFFPFFW.
..WWWWW..
---
..WWWWW..
.W.....W.
.W.....W.
.W.....W.
.W.....W.
.W.....W.
.W.....W.
.W.....W.
..WWWWW..
---
..WWWWW..
.W.....W.
.W.....W.
.W.....W.
.W.....W.
.W.....W.
.W.....W.
.W.....W.
..WWWWW..
---
.........
..RRRRR..
..RRRRR..
..RRRRR..
..RRRRR..
..RRRRR..
..RRRRR..
..RRRRR..
.........